🟧🟧🟧🟧🟧🟧🟧🟧
🟧🔸🔸🔸🔸🔸🔸🟧
🟧🔸🟧🔸🟧🔸🔸🟧
🟧🔸🔸P🔸🔸🔸🟧
🟧🟧🔸🔸🔸🔸🔸🟧
🟧🔸🔸🔸🔸➕🔸🟧
🟧🟧🟧🟧🟧🟧🟧🟧