🟧🟧🟧🟧🟧🟧🟧🟧🟧
🟧🔸🔸🔸🔸🔸🔸➕🟧
🟧🔸🔸🔸🔸🔸🔸🔸🟧
🟧🔸🔸P🔸🔸🔸🔸🟧
🟧🔸🔸🔸🔸🔸🔸🔸🟧
🟧🔸🔸🔸🔸🔸🔸🔸🟧
🟧🟧🟧🟧🟧🟧🟧🟧🟧