🟧🟧🟧🟧🟧🟧🟧🟧🟧
🟧🔸🔸🔸🔸🔸🔸🔸🟧
🟧🔸🟧🔸🔸🔸🔸🔸🟧
🟧🔸🔸P🔸🔸🔸🔸🟧
🟧🔸🔸🔸🟧🔸🟧🔸🟧
🟧🔸🔸🔸🟧➕🟧🔸🟧
🟧🟧🟧🟧🟧🟧🟧🟧🟧