🟧🟧🟧🟧🟧🟧🟧🟧
🟧🔸🔸🔸🔸🔸🔸🟧
🟧🔸🟧🔸🟧🔸🔸🟧
🟧🔸🔸P🔸🔸🔸🟧
🟧🔸🔸🔸🔸🔸🔸🟧
🟧🔸➕🔸🔸🟧🔸🟧
🟧🟧🟧🟧🟧🟧🟧🟧