🟧🟧🟧🟧🟧🟧🟧🟧🟧
🟧🔸🔸🔸🔸🔸🔸➕🟧
🟧🔸🟧🔸🔸🔸🔸🔸🟧
🟧🔸🔸P🔸🔸🔸🔸🟧
🟧🔸🟧🟧🟧🟧🔸🔸🟧
🟧🔸🔸🔸🔸🟧🔸🔸🟧
🟧🟧🟧🟧🟧🟧🟧🟧🟧